%%%%%%%%%%%%%%%%%%%%%%%%%%
%   ...   ......        o%
%  ..P..    ..           %
% ..   ..   ..   ... ... %
% .. o ..   ..     .   . %
% .......   ..   ...G... %
% .. G ..   ..   .   .   %
% ..   .. ...... ... ... %
%%%%%%%%%%%%%%%%%%%%%%%%%%
